11111
10CC1
1PEC1
10CC1
11111
