111111
1P1001
1000E1
1001C1
111111
