11111111111111111111
10C00100000000CC10C1
1000C100000PCC111001
100C0100E00100001001
10C0010000010C000001
10000000000000000001
1000C000100000000001
100000001000C0000001
11111111111111111111
