11111111111111111
10000000000000E01
10000000000C00001
1000000C000000001
10000000001111111
1000C000000000001
100000000C0000001
11111111000000001
100000000000C0001
1000000C000000001
10000000000000001
10C00000011111111
100000C0000000001
100000000000C0001
11111111100000001
1000P00000000C001
11111111111111111
