11111111
100001C1
1PC0EC01
11111111
